0..........................................................................................................................0
0..........................................................................................................................0
0..........................................................................................................................0
0000000000000000000000000000000000000000000000000000000000000000000000000000000000000000000000000000000000000000000000000000
0........................0.................................................................................................0
0........................0..................................................................................0000000000000000
0000000000000000000000...0.................................................................................................0
0........................0..................................................................................0..............0
0........................0...................................................................0....0.........0..............0
0...0000000000000000000000................00000.............................................................0..........X...0
0..................................................0.......................................................00000000000000000
0.......................................................0...................................0..............................0
00......................................0....................0........................................00...................0
0.....0...0...0...0...0...........................................0........................................................0
0......................................................................0.....................0.............................0
0.0........................0.....0....0.....................................0..............................................0
0................................................................................0.........................................0
0...........................................................................................0..............................0
00.........................................................................................................................0
0......................................................................................000.................................0
0..........................................................................................................................0
0.0........................................................................................................................0
0..........................................................................................................................0
0..........................................................................................................................0
00.........................................................................................................................0
0..........................................................................................................................0
0..........................................................................................................................0
0000000000000000000000000000000000000000000000000000000000000000000000000000000000000000000000000000000000000000000000000000